



    
    
       
       
           
           	
NO ./assets/n_flame_64x64.xpm
SO ./assets/s_flame_64x64.xpm
WE ./assets/w_flame_64x64.xpm
EA ./assets/e_flame_64x64.xpm
F 220,100,0
C 010,10,10

	
11
10111111
11  11 N1
     1011
1111111
