



    
    
       
       
           
           	

SO ./assets/s_flame_64x64.xpm
WE ./assets/w_flame_64x64.xpm
EA ./assets/e_flame_64x64.xpm
F 220,100,0
C 010,10,10
NO ./assets/n_flame_64x64.xpm
	
          1111111111111111111111111
          10000N0000110000000000001
          1011000001110000000000001          11111111
         1100100000000000000000000111111111  111 0001
11111111101100000111000000000000111             111111 
10000000011000001110111111111111
1111011   1111011100000010001
1111011   1111011101010010001
11000000110101011100000010001
10000000000000001100000010001
10000000000000001101010010001
11000001110101011111011110111
11110111 1110101 101111010001
11111111 1111111 111111111111
