



    
    
       
       
           
           	
NO ./assets/n_flame_64x64.xpm
SO ./assets/s_flame_64x64.xpm
WE ./assets/w_flame_64x64.xpm
EA ./assets/e_flame_64x64.xpm
F 220,100,0
C 010,100,0

	
     
     1111111111111111111111111
     1000000000110000000000001
     1011000001110000000000001
     100100000000000000000000111111111
111111111011000001110000000000001
100000000011000001110111111111111
11110111  111111011100000010001
111101111  11111011101010010001
1100000011010101110000001000111
10000000000000001100000010001                 1111 
1111111111111111111111111111111111111111111111111111
10000000000000001101010010001
11000001110101011111011110N0111
11110111 1110101 1011110100001
11111111 1111111 111111111111