NO ./assets/n_flame_64x64.xpm
SO ./assets/s_flame_64x64.xpm
	
WE ./assets/w_flame_64x64.xpm
EA ./assets/e_flame_64x64.xpm

F 220,100,0
C 0,30,4 



1111111111111111111111111
1100000111010101111110E011111
11110111 1110101 101111010001
11111111 1111111 111111111111






