NO ./assets/n_flame_64x64.xpm          
SO ./assets/s_flame_64x64.xpm
WE ./assets/w_flame_64x64.xpm
EA ./assets/e_flame_64x64.xpm

F    220,100,0
C       225,30,0

        111111111111111111111111111     11111
        1000000000110000000000001      111    
        101100000111000000N00000111
        100100000000000000000001
1111111110110000011100001111111
10000000001100000111011111  1111111
11110111111111011100000011111
1111011111111101110101001
110000001101010111000000111111
100000000000000011000000100011111
1000000000000000110101000000110001
11000001110101011111010000000000011111111111111111
11110111 1110101 10111100000100001
11111111 1111111 11111111111111111
