NO ./assets/n_flame_64x64.xpm
SO ./assets/s_flame_64x64.xpm
WE ./assets/w_flame_64x64.xpm
EA ./assets/e_flame_64x64.xpm

F    220,100,0
C       225,30,0

111111111111111111111111111111111
100000000000000000000000000000001
100000000000000000000000000000001
100000000000000000000000000000001
100000000000000000000000000000001
100000000000000000000000000000001
100000000000000000000000000000001
100000000000000000000000000000001
100000000000000000000000000000001
100000000000000000000000000000001
100000000000000000000000000000001
100000000000000000000000000000001
100000000000000000000000000000001
100000000000000000000000000000001
10000000000000000000000N000000001
100000000000000000000000000000001
100000000000000000000000000000001
100000000000000000000000000000001
100000000000000000000000000000001
111111111111111111111111111111111
