NO ./assets/n_flame_64x64.xpm
SO ./assets/s_flame_64x64.xpm
WE ./assets/w_flame_64x64.xpm
EA ./assets/e_flame_64x64.xpm

F    220,100,0
C       225,30,0

111111111111111111111111111111111
1N1100000001001000000111100000001
101101111001001001110100001001001
101101000001001100000101111001001
101101011001100110010001000000001
101000011001110010011101111111001
101000100100010011001001000000001
101000111100000001100011100111111
101000000001100111100010000000001
100001111001110000100010011111001
101000001110011110001110011001001
111111101000010011111000000001001
100000111000010000000010111111001
100100000010011010011110000000001
100100110010000011010000111001001
100111111110010011010111101001001
100100000000110000010000001001001
100101011111110011110011111001001
1000010000000000000000100000000N1
111111111111111111111111111111111
